...............
.#############.
.#...........#.
.#...........#.
.#...........#.
.#...........#.
.#...###.....#.
.#...#.......#.
.#####.#####.#.
.............#.
