.....#..#................#...###.......
..................#...........#........
....#..................................
.#.............#...........#...........
....#..#................#..............
...........................#....#.##...
...........................#...........
.....#..............#........#.........
........#..............#...............
......#..............................#.
................#..#...................
..#.............................##.....
#......................................
..............................#........
..............#...............#........
...................................#...
.........................#.............
.##.............#......................
....#.................#.....#..........
#..................................#...
.....#..................#..............
......#......#.......#......#.#........
.......................................
...........#.....#.....................
........#..#...........................
...........#..............#............
......................................#
.......#.............#.................
.......................................
......##...............#...............
.........#..#..........................
...#..............................#.#..
.......................................
.....#.......................#..#......
..........##..........................#
..#....#....................#..........
.#....#................................
..........................#.......#....
.#......#.#............................
.....................................#.
