##########
#........#
#.#.##.#.#
#.#....#.#
###.##.#.#
#......#.#
#.####.#.#
#.#....#.#
#.###..#.#
######.#.#
