...######################################################################################################################
..................#..#........#........#..#..#..#.....#..#..#..#........#..#.....#.....#........#..#.....#........#..#..#
#..#..#..#######..#..####..#..#..#######..#..#..#..#..#..#..#..#..#..####..####..####..#..#..####..#..#..#######..#..#..#
#..#..#.....#.....#........#..#..#..#........#..#..#..#..#.....#..#........#.....#..#.....#.....#.....#........#.....#..#
#..####..#######..####..#..#..#..#..#..#######..#..#..#..#..####..####..#######..#..#..################..####..#..#..#..#
#..#........#...........#..#.....#..............#..#........#..#..#...........#........#.................#.....#..#.....#
################..#############..####..#..#..####..#######..#..#######..####..####..##########..####..####..##########..#
#.....#........#.....#.....#........#..#..#..#.....#........#...........#..............#...........#..#.....#...........#
####..#..################..#..#############..####..#..####..#######..#######..####..####..#############..#..#..#######..#
#...........#..#.....#..#.....#...........#.....#..#.....#.....#........#..#..#........#........#........#..#..#........#
#..#..#..####..####..#..####..#..#######..#..################..#######..#..#############..######################..#######
#..#..#..#........#..#...........#.................#.....#..#..#..#..............#.....#.....#..#.......................#
#..#######..#######..#..####..#..####..#######..#######..#..#..#..#..#..#############..#..#..#..#..#..################..#
#.....#.....#.....#..#..#.....#.....#.....#.....#.....#.....#........#.....#..#..#........#..#..#..#........#..#..#.....#
#..####..####..####..####..#######..#..##########..#..#..####..#..#..#######..#..#..#..#######..#############..#..#..####
#..#..#.......................#..#..#..#..#........#..#........#..#.................#........#..#..#....................#
#..#..#..#..####..##########..#..#######..#..#..#..#..#############..#..#..#..#..#############..#..####..####..##########
#..#.....#.....#..#..............#.....#..#..#..#..#........#..#..#..#..#..#..#........#.....#.....#..#..#..#..#........#
#..####..###################..#..####..#..####..#..#..#######..#..####..#############..####..#..####..#..#..#######..####
#.....#........#...........#..#.....#..#........#..#..#..............#.....#........#..#.....#..#.....#..#..............#
#..#..#..################..##########..#######..#..#..##########..#..####..#######..#..#..#..#..####..#..#..####..#..####
#..#...........#.....#..#.....#........#........#..#........#..#..#..#...........#........#..#..#.....#.....#.....#.....#
#############..#..####..#..##########..#..####..#######..####..####..#######..#######..#######..#..#..#..#############..#
#...........#........#..#........#..#..#..#..#.....#..#.....#.....#..............#........#..#..#..#........#..#.....#..#
#..####..####..#..####..#..####..#..#..#..#..#..####..#######..####..#..##########..#######..#..#..##########..####..#..#
#.....#..#..#..#..#........#..#.....#..#.....#..#.....#..#..#........#.....#..#..#..#...........#..............#.....#..#
#..####..#..#..####..#..####..#..####..#######..#..####..#..####..#..#..#..#..#..#############..#..#..####..####..#######
#.....#.....#........#.....#.....#...........#........#...........#..#..#..#.....#.....#........#..#..#..#........#.....#
#######..#..#..#######..##########..####..####..##########..####..####..#######..#..#######..#..####..#..####..####..#..#
#..#..#..#.....#..#..............#..#........#.....#..#........#.....#..#.....#..#..#.....#..#..#..#........#..#.....#..#
#..#..##########..####..#######..#######..#..#..####..#..#############..#..####..#..####..#..#..#..####..#..####..#..####
#........#.....#..#..#..#..............#..#....................#.....#..#.....#..#........#..#..#..#..#..#.....#..#.....#
####..#..####..#..#..####..#######..#..####..#######..#..####..#..#..#..#..#..#..#..##########..#..#..####..#######..####
#.....#.....#..............#........#..#...........#..#..#........#..#..#..#.....#.....#..#.....#..#...........#........#
#..#######..#..#..#..#..####..#..#..####..#..#..##########..####..#############..####..#..#..####..####..##########..#..#
#..#...........#..#..#.....#..#..#........#..#..#........#.....#..#........#...........#..#........#...........#.....#..#
##########..#..#..#..####..#..####..####..####..#..#############..#######..#..##########..#..##########..#..#######..####
#..#........#..#..#.....#..#.....#..#........#.....#.....#.......................#..#.....#........#.....#........#..#..#
#..#..#######..####..#..####..####..#######..##########..#..#######..#############..#..#######..####..#######..####..#..#
#..#..#..#..#..#.....#..#..#..#...........#..#........#..#..#..#.....#..#..#........#....................#..#..#.....#..#
#..#..#..#..#############..##########..####..####..#..#..#..#..#######..#..#..####..####..####..####..#..#..#..#..####..#
#.....#.....#.....#...........#.....#..#........#..#........#.....#..#..#.....#..#........#..#.....#..#..#..#..#........#
####..#..#..#..#..####..##########..#..#..################..#..####..#..#######..#..#######..####..#######..#..#######..#
#........#..#..#..#........#..#..#.....#..#.....#........#..#.....#........#...........#........#.....#..#........#.....#
#..##########..####..####..#..#..#######..#..####..#..####..#..#######..#############..####..##########..####..####..####
#.....#..#..#.....#.....#..............#..#........#..#........#.....#........#...........#.....#..#........#.....#.....#
####..#..#..#..#############..#######..#..#..#..#..#######..#..####..####..####..#..#######..#..#..####..#######..#..####
#........#..#........#.....#.....#..#..#..#..#..#.....#.....#.....#........#..#..#...........#.....#..#..#.....#........#
##########..####..#..#..#..#######..#..#..#..####..####..#######..####..####..####..#######..#######..#..#..####..####..#
#.....#..#.....#..#.....#...........#........#..#.....#..#........#..............#..#..#.....#..............#.....#.....#
#..####..#..#######..#######..#..####..#..#..#..#..##########..####..#..#######..####..#..#..#..#######..#..####..####..#
#...........#..#........#.....#..#..#..#..#.....#........#..#.....#..#..#.....#.....#.....#........#..#..#..#..#.....#..#
#..#..#######..#######..####..#..#..#######..#..##########..#..#..##########..#..#######..##########..####..#..#..#######
#..#..#...........#........#..#..#........#..#.....#...........#..#........#...........#..#.....#.....#..#..#.....#.....#
#..####..#..##########..#..#..#######..####..#..#######..#######..####..####..####..#######..#..#..####..#..#..#..#..####
#.....#..#........#..#..#..#.....#...........#........#........#..#..#..#.....#..#..#.....#..#..#.....#..#..#..#..#.....#
#..#######..#######..#..#..####..#..##########..##########..#..#..#..#..####..#..#######..#..#######..#..####..#..####..#
#..#..#..............#..#..#..#..#..#..#........#...........#..#..#.....#...........#.....#........#..#.....#..#..#.....#
#..#..####..#######..#..#..#..####..#..#######..####..#..#..#..####..#######..####..####..#######..#..####..#..#..#..#..#
#..#.....#..#...........#.....#........#..#..#..#.....#..#..#.....#........#..#..#.....#...........#..#........#.....#..#
#..#..####..################..#..#..####..#..#############..#..#..#..####..#..#..#..#..#..##########..#..####..#######..#
#.....#..#.....#.....#...........#..#.....#.....#..#..#.....#..#..#..#..#.....#.....#.....#..#.....#........#..#........#
####..#..#..####..#..#..#..#######..#..####..#..#..#..####..####..####..#..#############..#..#..#..#..################..#
#..#..#...........#..#..#..#.....#..#..#.....#..............#.......................#.....#.....#.....#..#..............#
#..#..#..#######..#..#..####..#######..####..####..#############..#..##########..#######..#..####..#..#..#######..#######
#..#.....#.....#..#..#.....#...........#..#..#...........#........#..#..#........#..#.....#.....#..#.....#.....#........#
#..####..#..##########..#..####..#######..#..#######..#..#..####..####..#..####..#..####..#..#..####..####..##########..#
#.....#........#.....#..#..#.................#.....#..#..#.....#..#........#........#..#.....#..#..#.....#.....#.....#..#
#..####..####..#..################..#############..#..##########..#######..#..#..####..#..#######..#..####..####..####..#
#..#..#..#...........#..#.....#........#.....#.....#..#.....#..#........#..#..#.....#..............#........#...........#
#..#..#..##########..#..#..#..#..#######..#..#..####..#..#..#..#..##########..#..#..####..#..##########..#######..#######
#...........#..#.....#..#..#..#...........#..#.....#..#..#.....#.....#..#.....#..#.....#..#..#.....#........#.....#.....#
####..#..####..#..#..#..####..#..#######..####..#..#..#..##########..#..#..###################..#######..#######..#..####
#.....#..#........#..#..#........#..#.....#.....#..#.....#.....#..#..#...........#........#..#...........#........#.....#
####..#######..#######..##########..####..####..##########..####..#######..#######..#######..#..####..####..####..#..#..#
#..#........#..#.....#.....#..#.................#..#.......................#..#..............#.....#..#.....#........#..#
#..#..#######..#..#######..#..#..#######..#######..###################..####..####..#..##########..#######..#############
#.....#..#..#........#........#.....#.....#.....#.....#.....#.....#..#.....#..#.....#........#.....#...........#.....#..#
#..#..#..#..#..#..####..####..#######..#..####..#..####..#..####..#..#..####..#..#######..#..####..#..#..#######..####..#
#..#.....#.....#...........#.....#.....#........#........#.............................#..#..#.....#..#.................#
######################################################################################################################..#

