....#.....
.......###
.......#..
..######..
..#....#..
..#.......
.##.......
........#.
#.........
......#...
