...######################################################################################################################
......#.....#..#..............#...........#..#.....#..#..#.....#......................................#.....#...........#
#..####..####..#..####..#..####..####..####..#..#..#..#..####..#############..#..#######..#######..#..#..#..####..#..#..#
#..#..#.....#........#..#........#..#.....#.....#........#.....#...........#..#.....#........#.....#.....#.....#..#..#..#
#..#..#..#######..#..#..####..####..####..#..####..#######..#######..#############..####..####..##########..####..#..####
#..#..#.....#.....#..#.....#........#........#..#..#..#..#..............#..#...........#.....#.....#..#.....#.....#..#..#
#..#..#..#..#######..#######..##########..#..#..####..#..#..#############..##########..#..#..#######..####..#######..#..#
#........#..............#..............#..#........#.....#........#..#........#........#..#...........#.................#
#..#######..#..#..##########..#######..####..#..####..#######..#..#..####..##########..#..#######..####..##########..#..#
#..#.....#..#..#.....#..#.....#.....#.....#..#...........#.....#.....#........#..#.....#..#........#.....#.....#.....#..#
#######..#######..####..#######..#######..####..##########..#######..####..#..#..#..####..#..#..#..####..#..#######..####
#.....#........#.....#.....#.....#..#.....#.....#.....#..#..#.....#..#.....#..#.....#..#..#..#..#.....#..#..#..#........#
####..####..####..#######..#..####..#######..####..####..#..#..#############..#..#..#..#############..####..#..####..####
#..#..............#........#....................#..#..............#...........#..#..#..#........#.....#.....#.....#..#..#
#..#######..#..####..####..#..################..#..#..####..#..####..####..####..####..####..#..####..####..#..####..#..#
#..#........#...........#..#..#.....#..#.....#...........#..#..#........#.....#.....#........#........#.....#..#........#
#..####..#######..#######..#..#..#..#..#..#..####..#..#######..####..####..####..#..#######..####..####..#..#..####..#..#
#..#.....#..#.....#.....#..#..#..#........#.....#..#..#........#........#........#..#...........#.....#..#........#..#..#
#..#######..####..####..#..#######..####..####..#..#######..#..#######..####..##########..#..##########..##########..####
#.....#........#........#..#..#..#..#........#.....#.....#..#..#..#..#..#.....#.....#..#..#..#.....#..#.....#..#.....#..#
#..#######..#..#..#######..#..#..#..#############..####..#..####..#..#######..####..#..#..#..####..#..####..#..####..#..#
#..#..#..#..#.....#..#........#..#.....#.....#..#........#..#...........#..#...........#..#..#..#..#.....#...........#..#
#..#..#..####..####..#######..#..#######..#..#..#..#######..##########..#..#..####..#..#..####..#..####..#..#..####..#..#
#..#..#........#.....#..#.....#..#........#........#.....#..#.....#.....#.....#..#..#..#..#........#........#..#........#
#..#..####..#######..#..####..#..####..####..####..#..##########..#..#..#..#..#..#############..#..#######..####..####..#
#........#...........#..#.....#..#..#.....#.....#..#........#.....#..#.....#..#........#.....#..#........#..#..#.....#..#
#..####..##########..#..####..#..#..####..####..#..####..####..#######..#..#..#..##########..####..##########..#..#..####
#.....#........#.....#..#.....#...........#.....#.....#.................#..#...................................#..#..#..#
####..##########..#..#..####..#..#######..#######..#######..#..####..#######..#..#..##########..#######..#..####..####..#
#..#.....#.....#..#..#..#..#..#........#..#.................#..#..#.....#.....#..#.....#..............#..#........#..#..#
#..#..#..####..####..#..#..####..####..######################..#..####..#..##########..####..#..#..#######..####..#..#..#
#.....#...........#........#..#.....#........#..............#........#..#........#...........#..#........#..#...........#
#..####..####..#..#######..#..#..##########..#..####..#############..#######..#############..#..#..####..#############..#
#.....#..#..#..#..#...........#..#.....#.....#..#..#.....#.....#.....#..#........#..#..#.....#..#..#..#.....#.....#..#..#
#..#######..##########..####..#######..####..#..#..#######..#######..#..##########..#..####..#..####..####..####..#..#..#
#########################################################################################################################
