....#.....
.........#
..........
..######..
..#....#..
..#.......
.##.......
........#.
#.........
......#...
