.....#..#................#...###..............
..................#...........#.............#.
....#.........................................
.#.............#...........#..................
....#..#................#.....................
...........................#....#.##..........
...........................#..................
.....#..............#........#................
........#..............#......................
......#..............................#........
................#..#......................#...
..#.............................##.....#......
#.......................................#...#.
